coagulation disorders	can lead to	excessive bleeding
hemorrhagic disorders	can result from	low platelet count
hemophilia	is a	coagulation disorder
vitamin K	is necessary for	normal coagulation
warfarin	is used to	treat coagulation disorders
thrombocytopenia	is a	hemorrhagic disorder
anti-factor VIII antibody	is associated with	acquired hemophilia
von Willebrand factor	is involved in	coagulation
factor IX	deficiency causes	hemophilia B
disseminated intravascular coagulation	leads to	widespread clotting and bleeding
prothrombin time	measures	coagulation function
platelet transfusion	is used to	treat hemorrhagic disorders
aspirin	can cause	hemorrhagic disorders
blood clotting	depends on	coagulation factors and platelets
liver disease	can lead to	coagulation disorders
bleeding time	measures	platelet function
heparin	is used to	prevent blood clotting
defibrination	can result in	hemorrhagic disorders
Xarelto	is used to	prevent and treat blood clots
thrombin	is necessary for	the coagulation process
tissue factor	activates	coagulation cascade
factor V Leiden mutation	can lead to	coagulation disorders
thrombosis	is the formation of	blood clots
platelet aggregation	is essential for	normal coagulation
disseminated intravascular coagulation	can be triggered by	sepsis
epistaxis	is a common manifestation of	hemorrhagic disorders
aspirin	inhibits	platelet function
factor XIII deficiency	can lead to	abnormal coagulation
thrombophilia	is a	hypercoagulable disorder
hemarthrosis	is bleeding into	joint spaces
endothelial cells	play a role in	regulating coagulation
anticoagulants	are used to	prevent blood clots
factor VII deficiency	causes	hemophilia A and B
D-dimer levels	are elevated in	coagulation disorders
platelet function test	evaluates	platelet function
protein C and S	are involved in	anticoagulation
antithrombin III	inhibits	coagulation
Von Willebrand disease	results from	deficiency of von Willebrand factor
thrombocytopenia	is characterized by	low platelet count
thromboembolism	is the formation of	blood clots in blood vessels
hypofibrinogenemia	is a	coagulation disorder
fibrinolysis	is the process of	breaking down blood clots
factor Xa inhibitors	are used to	prevent and treat blood clots
blood clot formation	can lead to	stroke or heart attack
urinary tract bleeding	may indicate	a hemorrhagic disorder
platelet dysfunction	can result in	abnormal coagulation
DIC	can lead to	multi-organ failure
menorrhagia	is a symptom of	hemorrhagic disorders
factor V Leiden mutation	increases the risk of	thrombosis
thrombocytosis	is a	coagulation disorder
venous thromboembolism	can lead to	pulmonary embolism
liver cirrhosis	can lead to	coagulopathy
bleeding disorders	can be genetic or acquired
fibrinogen	is necessary for	blood clot formation
thrombocythemia	is a	coagulation disorder
Coombs test	detects	antibodies that attack red blood cells
platelet count	is used to	assess coagulation function
thrombosis	is a common complication of	coagulation disorders
hemorrhagic disorders	are often diagnosed through	bleeding time test
heparin-induced thrombocytopenia	results in	low platelet count and increased risk of clot formation
tissue factor pathway inhibitor	regulates	coagulation process
HIT	can result in	life-threatening blood clots
deep vein thrombosis	occurs in	lower extremities
hemophilia A	is caused by	deficiency of factor VIII
factor V Leiden mutation	is a	genetic risk factor for thrombosis
acute promyelocytic leukemia	is associated with	DIC
thrombocytopenia	is a common complication of	chemotherapy
coagulation studies	include	PT	APTT	and TT
platelet dysfunction	can be caused by	certain medications
thrombophilia	can lead to	recurrent blood clots
bleeding tendency	is a	symptom of hemorrhagic disorders
lupus anticoagulant	is associated with	increased risk of thrombosis
vascular endothelial growth factor	influences	coagulation and fibrinolysis
hemophilia B	is caused by	deficiency of factor IX
aspirin	inhibits	platelet aggregation
DIC	is a	life-threatening disorder
thrombophilia	increases the risk of	pregnancy complications
liver disease	can lead to	impaired synthesis of coagulation factors
factor II	deficiency causes	abnormal coagulation
prothrombin mutation	increases the risk of	thrombosis
coagulation cascade	results in	formation of blood clots
thrombocytosis	is a	risk factor for thrombosis
antiphospholipid syndrome	is associated with	increased risk of thrombosis
hemarthrosis	is a	common manifestation of hemophilia
