other ear and sense organ disorders	can cause	hearing loss
meniere's disease	is a type of	other ear and sense organ disorders
hearing aids	are used for	other ear and sense organ disorders
acoustic neuroma	may be related to	other ear and sense organ disorders
ototoxic medication	can worsen	other ear and sense organ disorders
vestibular rehabilitation	is a treatment for	other ear and sense organ disorders
tinnitus	is a symptom of	other ear and sense organ disorders
bell's palsy	can affect	other ear and sense organ disorders
balance disorders	are associated with	other ear and sense organ disorders
otitis media	is a common cause of	other ear and sense organ disorders
meclizine	is a medication for	other ear and sense organ disorders
ear infections	can lead to	other ear and sense organ disorders
mastoiditis	is a complication of	other ear and sense organ disorders
earwax buildup	may contribute to	other ear and sense organ disorders
ginkgo biloba	is used as a supplement for	other ear and sense organ disorders
ear irrigation	is a procedure for	other ear and sense organ disorders
acupuncture	is sometimes used for	other ear and sense organ disorders
audiometry	is a diagnostic test for	other ear and sense organ disorders
sudden sensorineural hearing loss	is a type of	other ear and sense organ disorders
labyrinthitis	is a type of	other ear and sense organ disorders
otosclerosis	is a condition that can lead to	other ear and sense organ disorders
vertigo	is a symptom of	other ear and sense organ disorders
chiropractic care	has been studied for	other ear and sense organ disorders
ear trauma	can result in	other ear and sense organ disorders
conductive hearing loss	is a type of	other ear and sense organ disorders
mastoidectomy	is a surgical procedure for	other ear and sense organ disorders
tympanoplasty	is a surgical procedure for	other ear and sense organ disorders
cochlear implants	are an option for	other ear and sense organ disorders
mscmv	is a rare cause of	other ear and sense organ disorders
sscd	is a rare cause of	other ear and sense organ disorders
acoustic reflex testing	is used for	other ear and sense organ disorders
sudden deafness	is a complication of	other ear and sense organ disorders
barotrauma	can lead to	other ear and sense organ disorders
autoimmune inner ear disease	is a type of	other ear and sense organ disorders
giddiness	is a symptom of	other ear and sense organ disorders
chondritis	can lead to	other ear and sense organ disorders
noise-induced hearing loss	is a type of	other ear and sense organ disorders
acoustic trauma	can result in	other ear and sense organ disorders
ear protectors	can prevent	other ear and sense organ disorders
acoustic shock	can cause	other ear and sense organ disorders
ear and sense organ infections	can lead to	other ear and sense organ disorders
head trauma	can result in	other ear and sense organ disorders
hyperacusis	is a symptom of	other ear and sense organ disorders
persistent postural-perceptual dizziness	is a complication of	other ear and sense organ disorders
vestibular disorders	are connected to	other ear and sense organ disorders
ear congestion	can be a symptom of	other ear and sense organ disorders
aural fullness	can be a symptom of	other ear and sense organ disorders
ototoxicity	is a potential side effect of	other ear and sense organ disorders
tympanic membrane perforation	can result in	other ear and sense organ disorders
sudden hearing loss	is a complication of	other ear and sense organ disorders
childhood hearing loss	is related to	other ear and sense organ disorders
temporal bone fractures	can lead to	other ear and sense organ disorders
otoscopy	is used in the diagnosis of	other ear and sense organ disorders
vestibular schwannoma	is a type of	other ear and sense organ disorders
dizziness	is a symptom of	other ear and sense organ disorders
otosclerosis	is a cause of	other ear and sense organ disorders
vestibular neuritis	is a type of	other ear and sense organ disorders
eustachian tube dysfunction	is a cause of	other ear and sense organ disorders
cholesteatoma	is a complication of	other ear and sense organ disorders
fullness in the ear	can be a symptom of	other ear and sense organ disorders
otoscopic examination	is a diagnostic tool for	other ear and sense organ disorders
noise exposure	can contribute to	other ear and sense organ disorders
earwax blockage	can lead to	other ear and sense organ disorders
motion sickness	is sometimes connected to	other ear and sense organ disorders
foreign bodies in the ear	can cause	other ear and sense organ disorders
barotitis media	is an inflammation related to	other ear and sense organ disorders
musicians' earplugs	can prevent	other ear and sense organ disorders
central auditory processing disorder	is a type of	other ear and sense organ disorders
hyperacusis	is a symptom of	other ear and sense organ disorders
recurrent ear infections	can lead to	other ear and sense organ disorders
acquired hearing loss	is related to	other ear and sense organ disorders
ear-specific allergies	can cause	other ear and sense organ disorders
tympanic membrane retraction	can lead to	other ear and sense organ disorders
cholesteatoma	is a type of	other ear and sense organ disorders
blocked eustachian tube	can result in	other ear and sense organ disorders
ear trauma	can lead to	other ear and sense organ disorders
auditory processing disorder	can result in	other ear and sense organ disorders
